NO ./no_texture.png
SO ./so_texture.png
WE ./we_texture.png
EA ./ea_texture.png
F	 220       ,      100,        0
C								 225,		 30, 0

11111
1001S1  
11111
11111
11111
11101
11111
   111
   101
   111
