NO ./no_texture.png            

			
SO ./so_texture.png

WE ./we_texture.png							 
EA ./ea_texture.png
C 255,100,200
F 50,0,250


111111
1000W1
1111111

11111111111111
       11
    11101
1111111111111111



    111111111111111
111111111111111111111111






