11111
100S1
11111
                                   
11111
   11111
11101
11111
