11111
1001S1
11111
1 1 1

























11111
   11111
11101
11111
