








NO ./no_texture.png
 SO ./so_texture.png
WE	./we_texture.png							 
EA ./ea_texture.png
C 7,4,4

 F 7,4,40

111111
1000W1
111111
