NO ./img/cahuete.png			
SO ./img/cahuete2.png

WE ./img/cahuete3.png
EA ./img/cahuete4.png
C  255				  ,	153,102         
F  132,132,218

11111111111
100000N0001
11100000111
10000000101
10101010101
11111111111
