NO ./img/flo6.png			
SO ./img/flo5.png

WE ./img/cahuete2.png
EA ./img/suki.png
C 255,153,102
F 132,132,218

11111111111111111111
10000000000000000001
10111111111111111001
10000000000000000001
10111111111111111001
10000000000000000001
10111111111111111001
10000000000000000001
10111111111111111001
10000000000000000001
11111111111111111111
11111111111111111111
11111111111111111111
10000000000000000001
10111111111111111001
10000000000000000001
10111111111111111001
10000000000000000001
11111111111111111111
11111111111111111111
11111111111111111111
10000000000000000001
10111111111111111001
10000000000000000001
10111111111111111001
10000000000000000001
10111111111111111001
10000000000000000001
10111111111111111001
10000000000000000001
11111111111111111111
11111111111111111111
11111111111111111111
10000000000000000001
10111111111111111001
10000000000000000N01
10111111111111111001
10000000000000000001
11111111111111111111
11111111111111111111
