NO ./img/flo6.png			
SO ./img/flo5.png

WE ./img/cahuete2.png
EA ./img/suki.png
C 255,153,102
F 132,132,218

11111111111
100000N0001
11100000111
10000000101
10101010101
11111111111
