NO ./img/flo.png			
SO ./img/suki.png

WE ./img/cahuete.png
EA ./img/kanel.png
C 67,4,22
F 50,0,137

111111111111111111111111111111111
1E0000000000000000000000000000011
1001111111111111111111111111111  
100110000000000000000000000011111
100110011111111111111111110011
10011001000000000000000000001111
1001100100111111111111111111111
1001100100000000000000000000001
1000000100000000000000000000001
1111111111111111111111111111111
