NO ../img/leflo.png			
SO ../img/leflo.png

WE ../img/leflo.png
EA ../img/leflo.png
C 235,147,200
F 50,0,137

111111111111111111111111111111111
100000000000000000000000000000E11
1001111111111111111111111111111  
100110000000000000000000000011111
100110011111111111111111110011
10011001000000000000000000001111
1001100100111111111111111111111
1001100100000000000000000000001
1000000100000000000000000000001
1111111111111111111111111111111
