NO ./img/flo.png			
SO ./img/flo2.png

WE ./img/flo3.png
EA ./img/flo4.png
C 0,102,102
F 153,255,255

111111111111111111
1111010101010101
 111111111111111
1000000W000000001
11110000111101011
10000111111111111
11110000001
   111100001
      111111
