NO ./img/kanel_judgement.png
SO ./img/catually.png

WE ./img/kanel_chokbar.png
EA ./img/kanel_wut.png
C 200,124,0
F 140,0,155

11111111111111111111111111111
111000000010000000000000001
 1111100000000000000000001111
 1111000000S000011111111111
11110000000001111111111111
11111111111111111111
