NO ./img/flo.png			
SO ./img/suki.png

WE ./img/cahuete.png
EA ./img/kanel.png
C 34,77,12
F 50,0,250

11111111111111111111111111111
10000000000001111111111110001
1111111110010000000000000001
 1111100000000000000000001111
 1111000000N000011111111111
11110000000001111111111111
11111111111111111111
