NO ../img/leflo.png			
SO ../img/leflo.png

WE ../img/leflo.png
EA ../img/leflo.png
C 255,100,200
F 50,0,250

11111111111111111111111111111
10000000000001111111111110001
1111111110000000000000000001
 1111100000000000000000001111
 1111000000N000011111111111
11110000000001111111111111
11111111111111111111
