NO ./img/kanel.png
SO        ./img/cats.png
WE                                                                ./img/flo.png

EA            ./img/cahuete.png
F                109,67,20
C     255,204,255




















































        1111111111111111111111111
        1000000000110000000000001
        1011000001110000000000001
        1001000000000000000000001
1111111110110000011100000000000S1
100000000011000001110111111111111
111000000000000111100000010001   
100000000000001111101001000001   
10000000000011111100000010001    
10000000000001111111111111101    
10011000000100011111111111111    
10000000000000001101010010001    
11000001110101011111011110001    
11111111 1110101 101111010001    
11111111 1111111 111111111111    


























