NO ../img/leflo.png			
SO ../img/leflo.png

WE ../img/leflo.png
EA ../img/leflo.png
C 33,100,22
F 51,10,25

1111111111111111111111111111111111
1000000000000000001111111111
100S00011110000000000000000111111
111011011 111000000011111111
100011    111111111011      1
1001111111111111111001     10111
1000000000000001  11011111111
1111111110000001  110000000001
1       10000001   11111111111
1111111111111111111111111111111111

