NO ./img/suki.png			
SO ./img/suki2.png

EA ./img/suki4.png
WE ./img/suki3.png
F 255,204,229
C 102,0,0

111111
1110111111111
10000000000001
1111S001000011
1000111110001
1111111110001
1110000000001
111111111111
