NO ../img/leflo.png			
SO ../img/leflo.png

WE ../img/leflo.png
EA ../img/leflo.png
C 255,100,200
F 50,0,250

               11
              1001
             100001
            10000001
           1000000001
          100000000001
         11011111111011
        1000111111100011
       100000000000000001
      11111110111110111111
     11110000011111000001111
    1000000000000000000000001
   111111111000000000111111111
  11111100000000000000000111111
 10000000001111111111100000000W1
111111111111111111111111111111111
