NO ../img/leflo.png			
SO ../img/leflo.png

WE ../img/leflo.png
EA ../img/leflo.png
C 255,100,200
F 50,0,250

                1
               101
              10001
             1000001
            100000001
           10000000001
          1000000000001
         110011111110011
        10001111111110001
       1000000000000000001
      111111101111101111111
     11110000011111000001111
    1000000000000000000000001
   111111111000000000111111111
  11111100000000000000000111111
 10000000001111111111100000000W1
111111111111111111111111111111111
