
N ./img/flo.png			
SO ./img/suki.png

EA ./img/kanel.png
WE ./img/cahuete.png
F 9,77,56
C 50,0,250

11111
1000W1
111111
