NO ./img/flo.png			
SO ./img/suki.png

WE ./img/cahuete.png
EA ./img/kanel.png
C 87,33,55
F 50,0,250

11111111
1Nh00W1
11111111
