NO ./img/flo.png			
SO ./img/suki.png

EA ./img/kanel.png
WE ./img/cahuete.png
F 50,0,250
C 87,33,55

11111111
1Nh00W1
11111111
