
NO ./leflo.png			
SO ./leflo.png

WE ./leflo.png
EA ./leflo.png
C 255,100,200
F 50,0,250

11111111
1Nh00W1
11111111
