NO ./img/flo.png			
SO ./img/suki.png

WE ./img/cahuete.png
EA ./img/kanel.png
C 75,rere7,9,
F 50,0,250

11111
1000W1
111111
11111111111111
111111111111
1111111111111111
    111111111111111
111111111111111111111111
