NO ../img/flo.png			
NO ../img/suki.png

WE ../img/cahuete.png
EA ../img/kanel.png
C 9,77,56
F 50,0,250

11111
1000W1
111111
