NO ./leflo.png

			
SO ./leflo.png

WE ./leflo.png
EA ./leflo.png
C 256,1874700,200
F 50,0,250

11111
1000W1
111111
