NO ./img/flo.png			
SO ./img/suki.png

EA ./img/kanel.png
WE ./img/cahuete.png
F 50,0,250
C 	  256	,1874700  ,200

11111
1000W1
111111
