NO ./img/flo.png			
SO ./img/suki.png

WE ./img/cahuete.png
EA ./img/kanel.png
C 	  256	,1874700  ,200
F 50,0,250

11111
1000W1
111111
