NO ./img/flo.png			
SO ./img/jpg.jpg

EA ./img/kanel.png
WE ./img/cahuete.png
F 50,0,250
C 255,100,200

11111
1000W1
111111
