NO ./img/flo.png			
SO ./img/suki.png

EA ./img/kanel.png
WE ./img/cahuete.png
F 50,0,250
C 255,100,200

11111
1N00W1
111111
