NO ./leflo.png			
SO ./leflo.png

WE ./leflo.png
EA ./leflo.png
C 255,100,200
F 50,0,250

11111
1N00W1
111111
