
NO ./img/flo.png			
SO ./img/suki.png

WE ./img/cahuete.png
EA ./img/kanel.png
C 255,100,200
F 50,0,250

11111
0000W1
111111
